10
xxxxxxxxxx
xcx      x
x x xx x x
x   x  x x
xxxxxxxx x
x        x
x xxxxxxxx
x    x   x
xx x   xox
xxxxxxxxxx